type octile
height 50
width 50
depth 10
map
.@..@.@.@.@.....@.@.@..@@.@.@.........@.@.......@.
@...@@.@..@..........@.@.@......@...@.......@....@
.....@@@..@...@.....@....@@@....@.@@@.@...@@......
.@@.......@.@@@.@@....@.@.@.@..@...@@....@...@....
.@..@@.@.@.@@.@.@.....@...@..@@@..@@@........@@.@@
.....@@..@...@.......@...@...@....@.....@...@@..@.
.@.@..........@@...........@.@..@.@@@.@.@.@@@@@...
......@...@.......@.........@.@..@.....@@...@.@...
.@.@.............@...@.@@..@....@.@..@.@......@...
@@..@....@...@....@....@@.@@@@@..@@@.@@....@.@@..@
..@@.......@.@.@.....@..........@.......@.....@...
.@......@.....@@...@......@...@@@.@...@@..@..@@...
@....@..@...@.@.@@........@@..........@.@@@@.@.@.@
......@.....@.@.@@.......@.......@@.@@..........@.
.......@...@........@@.@@@.@...@...@..@@...@.....@
@@@.......@...@.@@..@....@@......@.........@.@.@.@
@@..@@@..@..@..@.@....@..@.@....@.@.....@...@.....
........@.....@..@..@.@....@.@.............@......
@@.@@.@.........@.@@@...............@.......@@@.@@
.......@.@@....@........@@......@.@..@.@...@@.@...
@@......@.@@..@@@.@@@........@....@.@@............
@.@......@.....@@..@...@.@.@.@....@@..@.@..@......
@@@...@@@....@@..@...@....@@...@..@@....@@.@.....@
@.@.@....@..@@@..@@..@@.........@......@..........
.@@@.@...@.@...@.......@@.@...@...@.@...@......@..
...@........@.......@..@@..@.......@.@.@..@.......
@..@.@@@.......@@.@...@....@.......@...@...@.....@
@@@.....@...@...@......@..@@@...@@@.....@.@..@..@@
....@.@.......@........@....@.@@...@@...@.@@...@@.
@.@..@@@@.@...........@.@......@.@...@@..@...@.@..
..@..@......@@............@..@........@........@@.
.@@.....@@.@@.@...@.....@@@.@....@@.@......@@@.@..
@...@........@@..@.@..@...@@@..@@@..@@....@..@..@.
@.....@....@.....@.@.@..@.@.@.@@@@.....@@.@@.@@...
.@..@.@@.@..@.@@...@.@@@@....@...@@...............
..@....@..@......@@.@....@@.@..........@@@@.@...@@
@@@..@.@@@@......@.@......@@@...@....@.@@@..@....@
@...@.....@@..@.@.@.............@..@@.............
...........@@..@.......@..@@..@.....@............@
.@....@..@.@@@....@@..@.@@.@........@@..@.@.......
.....@.......@@@....@.@..@....@@@@..@@.@@.@......@
.@.@@...@....@.@..@@...@.....@..@..@.@.@@.@..@....
.@..@@.@.@.........@..@...@......@.....@@@....@.@.
........@.@@.@..@@.@..@@@....@@....@.....@@.@.....
@...@....@..@@.@.......@@.......@@@..@..@@......@@
..@@..@@......@......@....@.@....@.@.......@@.....
.@@...@@@@@..@.@.@..@@.......@.....@.@.@.......@@.
@@...@...@.......@@.@.@@.@@........@........@@@@..
.@@..@@.@.........@@.@......@@.@@@.......@@..@.@.@
...@@@..@...@@@......@..@...@@...@@..@.@..@...@..@

.@...@....@..@@.........@...@..@.....@@@..@@@@....
.@.@..@.@...@................@........@.@@...@@@..
@@..@..@...@....@......@.@..@.@........@...@......
......@..........@@.@@.@.....@...@.@..@..@........
.@@.....@.@@......@...@....@..@...............@@.@
....@@.........@....@...@.....@@...@...@.@........
@@...@..@..@........@@....@.@...@........@......@.
.@..@..@............@..@...@@.......@..@......@@..
..@@@@@.....@....@..@.@...@.....@@....@@..@@......
@........@...@@..@..@@..@....@...@...@@.@........@
......@..@..@..@.....@.@.@@.....@@@@.....@..@@...@
...@.@..@....@.@.@....@@@@@....@@@....@....@......
.@@.....@.@.............@.....@@@..@..@.@.@..@.@..
.@....@@....@@......@.......@@..@..@.@....@...@..@
..@@...@.@@....@.........@.....@......@.........@.
...@...@....@........@@...@@@..@.....@@@...@@@..@.
.@@............@.........@.....@..............@..@
@@@.@...@............@@....@.....@...@....@@@..@@@
@....@@.@@@.@@..@@@.........@..@...@...@.....@@.@@
@..@..@...@...@@@.........@........@........@@....
@@..........@.@@.@.......@@.....@@@..@.@.@@.@...@.
........@....@..@...@.@....@@..@.@@.@...@.@.@.@...
.@@......@....@.@.@.@@...@@.@.@.......@@....@@..@@
@@..@..@.@@.@@@.@....@......@..@.@..@@@.@.@....@..
@..@.@......@...@....@@@@..@.@....@......@@@@..@@.
.....@..@.....@.@.@.@..@@@..@@.@..@.@....@.@.@.@.@
@....@.........@.@@@.......@....@@@..@@.@...@.@...
...@@...@....@@...........@.........@..@@.@....@..
.@..@.....@.........@.@.@.@....@@.@..@...@.@..@...
..@@...@...@@...@@..........@..@...@@..@.@.@@.....
...@...@@..@..........@@...@........@.........@...
@....@@.@@@........@@..@@..@@.@.@.@..@...@@...@..@
@.....@......@.@.@..@...........@..@........@@@...
@@.@...@.@.@.......@....@.@@..@@@@....@...@....@..
@....@.@@..@..@....@.@@..@....@@.........@@.@.@...
....@...@.@..@..........@..@...@....@.......@@.@..
..@.@..@.@.......@.@@@@.....@.@........@@@.......@
.@@.....@......@....@@...........@@@......@.....@.
@..@@.....@@.....@........@.@@........@...@.......
...@...@.@@@.@....@@@..@..@@..@....@......@@..@..@
@..@.....@@.....@.@......@.@.........@@@@.......@.
..@@@...@@...@......@@@....@..@@.@.......@....@..@
.@@@@....@.@@...@@...@.@..@.........@...@..@@.....
.@@...@...........@..@...@@...@.@.....@@.....@...@
.....................@...@...@.............@.@..@@
.@@.@@..@.@@.@@..@@@.........@@@@@@@.@............
@@@.@...@.@..@.@@..@..@.....@..@@........@.......@
..@@..@@....@.@..@.................@@@....@...@...
..@.@@..@.@.@...@.@......@...........@@..@..@.@...
.@..@...@@....@.......@.....@...@.@.@.@@@@...@...@

....@.....@......@@...@@...@....@..@@..@.......@..
...@.@......@@..@..@.....@.@......@....@....@.@.@.
....@.@..@.@.@@@.....@@...@......@..@.@@..@.....@.
@@...@@.@..@@....@...@.....@.@.......@........@...
.@@.......@@.....@@@@....@.......@@....@@@@...@...
@@....@....@@......@@.............@...@....@....@.
@@@@@@@@@....@@..@..@@..@@.......@....@...@@...@..
.......@..@@@@.@@@@.@..@....@..@..@..@......@.@@@.
@.@.@.@..@.@....@...@.@@@...............@@...@...@
.@@@.....@..........@.....@.....@..@@.@.@....@....
.@.@@....@....@.@.@@.@@.@@.@.@.@.....@@.@...@...@.
@@..@@...@@..@@.@.@@@..@......@...@....@.....@@@..
@....@@@..........@...@@..@..@.....@@.@..@.@..@@..
@..........@..@...@...@.......................@@.@
.@....@.@@..@.....@@.@@@@@@.@......@.@.@@..@....@.
.@@......@@.@@@@................@.......@.@....@..
@.......@@........@@..@...@.@@@...@.@..@@..@@.....
.@........@.@....@@......@@.....@..@......@.......
@@...@.....@.@@@@@@.@..........@..@...@...@.......
..@.@@..@.@.....@....@..@@....@.@.@..@.@@.@.@.@.@@
......@@.@@...@@...@.....@.@..@@@@.@@.@.@....@@@.@
...@.....@.@......@..@@@.@..@@............@@@@...@
@.@..@...@.@....@...@.@.....@.@.......@.....@.....
@@......@..@@...@.@@..@.....@.@..@....@.@..@....@.
..@....@@.@@.....@@.@.@...@@.@.....@..@@..@..@@@@.
..@@....@......@..@.@..@.@...@@...@.@@.@...@...@.@
.....@@.@..@@...@.@...@....@........@....@...@@@@.
.@.@.@...@.@@@..@@.....@@@....@...@..@.@@@.....@..
@.@@..@........@@......@.@.@@.@...@..@..@@...@@...
...@......@..@..@....@@@.@.@.@.....@.@..@.@@......
.@@.@.@...@@.@......@@...@..@@....@.@@@..@.@@.....
....@....@@@....@..@..@@@....@..@@.......@.@@@....
...@.@@.@....@....@@.@...@.......@.@.....@@.....@.
.@@@....@.....@..@...@.@.@.......@..@.............
..@@@@@@@...@..............@.....@....@....@......
..@@...@@.@.@..........@...@...@..@.....@.......@.
..@....@@@.@@...@@@.@..@@.@..@@.@@@...@..@.@..@.@.
.@.@..@....@......@.@..@.@@...........@.@.@@......
.@..........@@..........@..@...@...@.@@@...@....@.
...@...@@.@@..@..@...........@..@@@@....@@@.@....@
.@.@@....@.......@...@@@.............@@.@....@....
...@....@@@@......@....@.@.......@@.@...@...@....@
@@..@@....@....@...@.@...@.@@@......@............@
@.@...@.@..@.........@..@....@.....@....@@@..@....
.@....@@....@...........@.....@@@.@..@@.......@...
...@....@@.@.....@..........@.......@@.@.......@.@
.@.@.@.......@..@.@@@@@.....@@@@.@@...@@@.@...@@.@
....@...@@.@.....@.@.@@....@@@...............@.@..
@...........@......@...@.....@.........@@.@....@..
.@.@.@..@.@.@.@..@.@@......@.@.@.......@...@@.@...

@...@..@..@.....@@....@@....@@..@.@..@.......@...@
@..@.@..@.@@@.@.@.@.......@.@........@..@........@
...@.@....@.@@@..@........@....@..@..@...@@@@@@...
.....@......@@@....@.@...@.@.@......@@@@..@@......
...................@....@...@@.@@@..@.@..@.@.@....
...@....@.@.@@..@...@@.....@.............@.@..@@..
@@@@@..@@..@.@....@..@.....@@....@..@.@......@@..@
....@@.@...@...@@....@.@.......@@...@.@...@.@.....
@..@@..........@@...@........@@.........@.@..@.@@@
@..@@....@.@@.@@.@@.......@.@......@.....@...@.@..
.....@.........@................@.@..@............
.@@@...@@..@..@...@@.@@@....@..@...@.@...@...@@...
@@.@.@.....@@..@@.@...@.....@@......@.@...@.@.@..@
.@......@......@@.@...@@....@.@.......@.@.........
@@.@.@..@..@.@.@........@@@...@.@.......@@@.@...@.
...@....@@.....@@..@..@.@@...@...@.@.@..@@..@.@.@.
@@.@.@@..@...............@...@.@..@.@@...@.@@@.@..
@..@...@@.......@@..@..@@@.@...@.....@@....@......
..@.@..@..@....@...@.@..@.@...@@...@@....@...@....
..@.@......@@@....@@.@............@@..@@...@......
.@...@..@.@@.......@@..@.@..@@..@@.......@.....@..
...@.@......@.......@...@@@..@...@@.@@..@....@....
..@@.@...@@@.@@.....@.............@...........@@..
@...@@.@.@.....@........@..@..@........@...@@@..@@
.@......@.@...@@@..@.@.@...........@..@@.@.....@.@
..@..@@...@@@@.@@@...........@@..@.....@.@.....@..
..@..@..@.@@@.......@@.@@...@.@@@....@.....@...@..
.@..@@....@@.@@.@@.......@....@@.@.@.......@@...@.
.@@@.@...@@@..@@@@.@...@.@.@@..@..@.@@@@@.@.@..@..
.@.@@@........@...@....@....@...@..@@...@.@..@....
.....@.@@@....@@.@@@...@..@@@.@.....@..@..@@.@..@.
...@.....@.........@...@.@..@@@..@..@....@...@.@..
..@@.@@@....@...............@................@....
.......@...@....@@@@@@....@.@@......@.@.@..@@...@@
..@...@..@.@.@.....@..@.@.@....@@...@@..........@.
...@.........@.........@.@..@@@.@@..@@@...@..@..@.
.....@..@...@.@........@.@@@.......@.@....@.....@.
...@.@.@....@...@@@@.....@@....@..@...........@@..
..@@.....@@..@@.......@@@....@...@.@..@.@.@@...@..
.@.@..@..@..........@@....@...@.....@.@...@...@..@
@.@@..@@.@@.........@.@@..@.@..@@@.......@@....@.@
..@.....@..@...@.........@@..@@..@...@@......@..@.
@@.@............@@...@..@...@.@@..........@.@.@...
.@.@.@.......@.@.@...@@..@@....@@.........@....@@.
...@..@@.@@........@........@..@...@.@....@@@....@
........@....@.@.@@..@.@..@...@...@..@.@......@...
......@.@@..@.@..@@@.@@...@.@..@.........@...@.@..
@...@.....@.....@.....@..@@....@..@@@.@@...@...@@.
..@.@.@@..@@.@@.....@..@@.@@..@..@..@.@@..@.@@@...
.......@.@....@@.....@@....@@@@.......@....@@.....

.@@......@...@......@...@.....@@..@@..@.@..@.....@
@@...@..@.@.....@..@.@.@............@.@@@..@.@@...
..@@.....@.@@@..........@..@..@.........@@...@.@..
...........@@..@....@............@.........@@@....
...@.@@.@@.@@@..@.......@..@..@.@.@......@@.@.@@.@
.@.@@@...@.......@..@.@@.@................@.@..@..
......@..@.....@.@..@.@...@@..@@@.........@@.@....
@..@@@.@.......@.@@@......@@...@@..@@......@.....@
.@.@@...@...@.@.@.@......@....@....@..@@.@@@......
.@...@..........@@.....@..@.........@@@@@@........
@...@@..@@@.@.@.@.@..@..@.@.@.@....@.........@@@.@
@.@..@..@..@.@...@..@@.@@@@........@.....@........
......@.....@@...@.@......@@@.......@@@.@.@..@....
.@...@@@@@....@..@........@.....@....@.@@@@@..@.@.
.........@..@@......@@@..@.@.@@...@@...@...@@.....
.....@..@.@..@@.@........@@@..@..@@...@.....@.@@.@
..@@.@..@...@.....@..@.....@..@..@..@.@.@..@@@....
.@@..@@..@.@.@....@....@.....@..........@..@.@....
.@@@@..@......@.@.@....@.....@.@.@.@............@.
@.......@.....@.....@.@...@.@.@.@....@@@.@@.@....@
..@..@...@.@.@.....@@..@@@@..@@.@......@......@...
@..........@..@.......@...@..@@............@@.@...
@.@@@.@......@.@@........@@..@..@.@.......@....@@.
.@@........@..@@.@..@.@..@@@.@.@.@@@.@@..@....@.@@
@.@...@@@.@@@..........@.@.@@...@@.......@@@.@@@.@
...@..@...@.....@.......@......@...@..........@.@.
@......@@.@@@...@...@..@@@.@..@..@@@.@.@..@@....@.
@.....@.@@......@@@.......@..@..@.@..@.....@......
......@@@.@..@.@.@.@@..@@@..@.@...@@@.....@....@.@
...@..........@@@..@...@........@@@.........@.@@@.
.@......@....@@....@....@.@........@@@..@.......@.
@..@.@@@......@..@....@.@.@.@@...@.@.....@.@.@..@@
@.@........@....@....@.@.@.@@...@.@@.@.@@.@.@@.@.@
......@@@..@@.@@.......@...@.@.@.....@.....@@.@...
.@..@..@@@.......@@.@...@@...@.....@..@...@@@.....
@.@@.......@.@.....@@.......@@@@..@@@....@......@.
@........@.@@..@.@....@@.@.....@@..........@@@@.@.
.@.@.....@@.@@......@..@.@...........@@@.@.....@@.
...@...@....@..@.@...@.......@..@.@@..@.@@.......@
.....@.@..@...@@..@..@..........@@..@.@.@......@.@
.....@.@@.@..@@.@.@.@@.....@..@@...@...@...@.@...@
@.@.......@@........@.@..@.@.....@.....@..........
.@......@@...@..@.@...@@@@.@@...@..@@....@..@.@@..
...@@.@...@@...@...@.@@.......@@..@...@@@.@@@@.@.@
@..@@@...@@...@..@......@..@@.@..@@.@.........@@..
...@..@.........@@..........@@...@...@@.@..@...@..
.@@....@.@........@..@.@..@.....@.....@@@...@@...@
...@.....@.@@@@.....@........@..@@.@.@.@.@.@..@..@
@@.....@....@.....@..@.@@......@@.@...@......@....
@..@@.@....@.............@@.......@..@...@.@.@.@..

@.@.....@...@@..@@..@.....@@@@..@@.......@..@@@...
.@.@@.@.@...........@.......@..@...............@@.
.............@..........@..@@.....@..@@........@.@
..@........@...@....@..@@.@..@@@.@.@@.@.....@@.@..
.@.........@@......@.......@........@..@@.@...@.@@
....@.@...@.@@..@...@@.@.@........@..@@.@.....@@@.
.........@@.@@@.......@@@.........@@@@.@@....@..@.
@@....@.@..@..@........@@..@.@.......@....@.@@....
@...@..@...@........@@@..@.@@...@@.........@.@.@.@
.@.@@@.@..@....@@.@@..@@@@.........@@..@@.@@.@.@.@
.@.@@.......@..@.@........@.@@........@......@@...
@..@..@@..@@.@@.@@.....@.@....@@.@.@@.@@........@@
@..@.@@.@..@.@.@.@@.@...@........@..@.@.........@.
.....@.@.@@.@..@.@...@...@.@.................@@.@@
.@@..@.@....@@.@.@.......@.......@......@.@@...@..
.@.@@......@...@..@..@@.@@..........@......@......
..@@.......@.....@..@.@@.....@@...@.@..@@.@.......
.@...@...@@@@..@@...@...@.@@.............@.....@@.
.@.....@@@.@......@...@.....@.@@@.@...@@@.@@..@...
.......@.....@.@.....@@..@@...@.@....@@..@..@..@@.
.@...@..................@.@@..@@......@......@.@@.
@...............@.@.....@......@......@...@@@@....
.......@..@..@@@......@.@@@...@....@..@....@......
@..@@@..@...@.@@.@........@.......@..@.@.@.@....@.
@..@.....@.@@.@...@@..@@..@@@..@@.....@@..@.......
@........@@@@.@..@....@....@@@.@@........@..@....@
.@..@..@@......@@....@@.....@@..@.@.@..@@..@......
@..@@@.....@...@.@..@....@.@.@..@@.......@.@...@.@
..@..@@@....@..@@.....@.....@...@@..@@....@.......
@.@@@..@..@@@...@..@.@......@............@...@@@.@
@@@..@@.........@.....@....@........@@......@.....
...@.....@.@........@....@...@.@..@.....@@..@..@.@
@@....@...@............@..........@.@...@..@.@...@
@@.@...@..@..@..@...@.................@..@..@@...@
...........@....@.....@....@@.....@@.....@....@.@@
............@.....@@....@.@@.@...@..........@..@.@
...@.@.@.@.@.@@.@..@..@..@..@....@..@...@@..@@.@..
...@....@.....@.......@.@@...@..@...@....@.@.@..@.
.@.....@@...@..@@.@...@.@...@......@..@..@.@......
.@...@@@..@.......@@@@.......@@...@.@@..@..@....@@
.@....@....@......@.@@.@..@.@@.@..@@@.@..@.@@.@@..
..@@......@.@......@@@..@@@.@..@..@.........@.....
....................@@..@@...@..........@.....@@.@
@........@@........@..@.@..@@.....@@.......@..@@@.
.@.......@@..@........@@@@.@.@@.@@@........@.....@
......@@..@@...@@..@......@....@..@@@..@..@@..@@@.
.....@@..@...@.....@...........@....@....@.@.@...@
...@...@@@.@....@.@@.....@......@.@@............@.
..@....@@....@@.@..@...@.@........@...@@@..@@@....
.....@.....@...@.@.@@....@.@....@.@..@...@......@@

.@.....@.........@..@....@.@.....@.........@......
..@@..@.@@.@........@@.@..@...@.@.........@.@.....
..@..@....@@....@...@@@.@...@.......@....@.@@....@
.....@..@.@..@...@...@@..@.@...@.@...@......@.@...
....@.@.....@.@....@..........@..@.@.....@@.@@.@.@
..@@@....@@.@....@...@@.@..@...@@@.@...........@..
.....@....@@@@.@......@.@..@......@...@..@@@...@.@
......@@...@......@....@@..@.@.@@........@@@@@..@.
....@...@...@..@@..@@@@..@...@@.@..@...@@....@..@@
.@......@@...@.@@.@..@.@@@.@@.@@.@@@......@.....@.
.....@..@@......@@........@.@...@....@..@...@@@...
...@.......@@...@@...@...@.@....@.@.......@......@
........@..@..@..@.@@@.@.......@.@..@@..@...@.@...
..@@@..@@..@.@@.@...@.@.@@....@@...@@@..........@@
.@.@@.@..@.........@..@@..@.....@...@..@....@..@..
...@...@....@..@.@....@.@.@.@....@@..@...@.@.@....
...@....@..@..@.@.@.@..@.......@.........@..@..@.@
.@.@@@..@@@......@@..@.@......@.@.@......@@.@..@..
@.....@@.............@.@....@.....@...@......@...@
....@..@.@@...@.......@.........@@.@@.@.@....@....
.........@.....@.@............@@.@.@.......@..@...
..@@.@..@...@.....@@....@....@.@..@...@......@..@.
.........@@@...@@.......@@.@@@@...@.......@..@...@
@...@.@.@.......@@....@..@......@........@...@..@.
.@...@..@@...@@.@@.....@...@@...@........@........
@...@...@@.@......@........@......@@.@.@....@@.@.@
@...@...@...@.....@.@@.@..@........@@.@@@@.....@.@
.@..@..........@@@@..@..@@...@....@.@..@..@.....@.
............@.....@.@.@.@.....@.@@..@....@....@...
......@.......@.@@..@..@.....@.@...@.....@..@..@.@
.....@@..@..@......@.......@.@..@.....@......@@.@.
.@.@.......@@@@...@.......@...@..@..@...@.@......@
....@@.@@.@.@@...@.@...@@.@...@@@....@@.......@...
....@............@.@....@@.@...@....@.....@@@...@@
.@@@@.@@@@.....@..@@.@.....@@@...@@@.@@@........@@
.@......@..@@.@@....@....@@.@@...@.....@.@.@......
...@@........@..........@....@....@...........@..@
....@...@....@@..@.@.@@....@.@@.....@...@@.@@@....
@.@@...@@.@.@..@@..@@.@@@@@@.@.@@...@......@......
.@...@...@.@.@.......@....@.@......@...@.@@.@..@.@
@.@@@...@..@..@.@....@...@...@@.@...@@.....@@.....
@..@......@............@@.@...@......@.@@........@
..@.@....@@@@.................@..........@...@@..@
@.@..@.@@......@....@.........@...@......@.@..@@..
.@.@.@......@@...@.@....@@.....@....@.@.......@@.@
@..@.@..@..@..@.@...@...@...@.@.@..@....@.@@....@@
@@@...@.@.@@.@@.@.....@.@@.@@...@@...@....@......@
...@..@@@@..@@.......@.@.@........@....@....@.@...
.@@..@.......@@....@.@.......@..@.@............@@.
@@.@....@..@@..@@...@@@@....@@@..@.@.....@@...@.@.

.....@@@@.............@@@..@@...@.@@.........@@...
.@...@@....@.@......@.@.@@.@.@@.@@@..@.......@@@..
@...@....@@@@.@......@@..@.@..@.........@...@.....
...@....@.@..@.@.@..@....@..@...@.@...@.....@....@
@@@..........@...@@.@..@@@........@...@.......@@..
...@.@@.......@@..@@..@..@.@@@...@..@..........@@@
.....@.....@........@..@..@@.......@.....@.@@@..@.
....@...@...@...@....@...@@........@.@.@..@@@.@...
.@@..........@.@@@@@.......@...@@@.@..............
@...@.@@@.....@...@...@@........@@@@....@@......@.
..@@.@.@....@.@..@.@...@@...@.@@@....@@@@@.@....@.
@...@........@...@@..@..@......@@@..@.....@.@..@..
@@@.@........@@...@.....@..@..@.....@@...@.@@.@..@
.........@..@.@...@.@..@...@@...@...@.@...@.@.@@..
@.........@@.....@.......@....@.@..@@......@......
..@..@........@@..@..@.....@@..@..@.@......@.@.@..
..@@...@....@......@@@@...@.@@..@.@@.......@......
......@@..@.@..@@...@..@........@.........@.@..@..
.....@@@...@@......@...@.............@@@.@....@...
.@@.@........@.@@..@....@...@.@.@..@...@@.....@..@
..@@@....@.@@.......@..@.@@.@...@.@.@..@@@..@..@..
....@@.@..@@..@...@.....@..@.@..@@@..@.@......@@.@
..@..@.........................@.@@@.@@.....@....@
.....@..........@.@...@...@.......@@.@.....@.@@...
...@..@............@.@...@@.......@.@...@@@...@@.@
@...@...@.@..@.....@@@..@.........@...@.......@@..
@.@....@........@@..@.@...@@.@..@...@@.@@...@.....
@.@...@.....@..........@...........@@......@@.@...
.@..@@@@...@@@...@.@.@.@...............@..@.@@@@..
.@.@...@.@...@..@.@@@@@...........@....@......@...
.........@@@.@....@..@..@.@......@...........@@@..
@..@.....@..@..@.@..@.@@....@.........@@@@.@@..@..
.@@......@.@.....@@.....@.@..@...@..@@.@@@...@..@.
@..@.....@@.@@@..@..@.....@@.....@......@@...@..@.
..@@@.@@..@...@@@@..@@@..@.@..@.@..@@@.@..@@.@....
@...@.....@....@...@.....@.........@@@@..@........
.@@..@...@....@..@.@.@@@...@.@....@@@@@@@.@...@..@
.@@..@@....@@@.@...@.@.......@@@.....@..@.@@..@@..
.@@.@@@.....@@...@.......@.@@@.....@@..........@@.
.@@@.....@..@@@.@.@.@@@..@.....@@........@.@.@....
.@...@@..@.@@@@@..@..@..@.@......@.@@@...@........
@...@....@@@...@@......@@.@..@.@.@....@.......@...
.@....@....@@.@@..@@.@..@.@.......@.@..@...@....@.
..@@.....@.@......@@@.@.@..@.@..@@@......@..@...@.
......@...@@.@..@@..@@...@@@.@......@@@@.....@@...
....@@.@@.@@.....@....@.@...@...@@@............@@@
.@@....@.....@...@@@.@...@.......@@.@..@@.@@@@..@.
.......@....@....@.@.....@@..@.....@@......@.@.@..
@.......@@@@.@...@.@@@..@...@@...@..@@@....@.@..@.
@@...........@.@...@@..@..@@........@.@..@@....@..

...@..@.....@@.......@...@.......@...........@....
@@.........@....@.@......@.@...@.@..@.@@...@.....@
@..@..@...@...@......@..@@.........@.@...@@@.@@...
.@..@.@...@....@.@@...@.....@.@.@.@@.@..@@.@..@...
..@.............@....@@@...@...@.@@@@.....@@@.....
.@......@..@.@@....@.@@@@..@..@.@@.@.........@@@.@
..........@..@...@..@..@.........@..............@.
...@.....@....@..@....@....@.@@....@.@.....@......
@...@.@@.....@@@.@......@.@....@@@.@....@@....@...
..@.@.@....@..@@....@..@........@.....@.@...@....@
......@..@.@...@........@@.@@@......@.@.@...@.@..@
@..@..............@.@@....@.........@.@.@......@@.
..........@@...@@.@...@.@......@....@.@....@@.....
.@.@@@........@..@@@....@@....@.@.@@@.@....@.@.@@.
......@.@@.@.@..@@@.....@@@@....@....@@.@.@@..@@..
.@.....@.@@@.....@.@@.@.@........@@.@@..@...@...@.
..@.@..@@..@@.@.@..@@...@...@......@.....@@..@....
.@...@.........@.........@..@....@@@..@..@@@@.....
@...@.....@..@.@@@@....@.....@....@@......@.@@.@.@
......@..@@..@...@......@...@......@.....@..@.@@..
@@@..@@@.@.....@.@..@....@....@@.@...@..@...@..@..
.@.........@........@@.@..@@....@.....@@.@@....@..
...@.....@..@@...@..@.@..@...@......@..@.......@..
.....@..@.@@@.......@..@.@.@..@...@.......@@......
...@.@@@.@@..@@...@@.@..@@.@...@@@.@@@.@..........
.@@..@@.......@@@@.........@..@.@@@..@...@@.......
...@...@.........@.@@@.@@.@.@.@..........@.@.....@
.@...@..@@.@...@..@.........@@.........@.@.@......
..@....@@@.@..@..@..@@...@@.............@@@@@.....
@..........@..@..@@.@...@..@....@..@.@@.@.........
.@@...@@..@.@.....@..@.@........@@....@@.@@@.@@@.@
...@......@.@....@.@@.@....@.@....@..@..@......@.@
@....@.....@@..@.@.@........@.@.....@@....@.@.@...
...@...@..@...@@..@@@@...@@....@.@@..@...@...@@...
@....@.@.@.@.....@@.@@@.@@..........@@...@.....@@.
...@@.....@...@@@.......@.@@..........@@@...@.@...
@.....@@.@...@........@..@..@...@.@.........@..@.@
....@@......@@.@@.....@@@.@.@@..@@..@@@...@.@.....
...@......@......@....@...........@....@@@@@@.....
@..@.@.......@...@@@..@....@@.@..@................
......@@....@@..@.@..@..@@.@..@@@.@.@@..@@.@...@@.
......@@@@@..@.@@..@.@...@@...@.@@@..@...@..@.....
....@..@.@@@.@@.@.....@..@.@.@..@.@..@.@.@.....@..
....@.@..@...@..@@@..@.@.......@..@..@@@@..@@.....
.@..@.....@..@.@......@..........@...@..@@....@...
.@.@......@........@...@@.@.....@@.@@.@....@@@....
...@@...@...@.@..@@...@..@...@.@@..@......@.@....@
........@..@@.......@...@.@@@..@@@...@..@.......@@
..@......@...@.@@..@........@.@...@..@...@@..@.@@.
@..@.@@@.....@@..@@..@.......@..@.......@.@.......

............@..@@..@@@@..@....@@.......@@...@.@@.@
..@..@....@@......@@.....@.@@..@...@.@...@@......@
......@@...@.@.@..@..........@.@.@.@.@...@@.......
..................@..@..@.@.@...@.......@.@...@...
@...@@.@...@...@.......@@...@..@@..@@@.........@..
@..@..@.....@...@@@@@..@.@@@@@...@@.@...@@........
@@@.@..@..........@.@.@..............@.@.@........
.......@.@.@.........@....@........@@....@.@@.@.@.
.@...@....@.@.@.@....@.@@@@....@......@.@....@....
@...@.@@.@..@.@@@...@@.@.@......@....@.@@....@..@@
..@.@@@......@......@........@.@@..........@..@...
@.@.....@...@@.@@..@@..@......@@@....@.@.@.@..@@..
@@.@.@@..@@..@@..@.@@.....@.@@@..@..@...@@@.@.....
...@.@@.@..@@.........@@@.@.@...@.@...@.@...@@@...
..@@..@@..@.@@@.......@..@.....@..@.@....@...@....
..@......@@...@@..@...@..@..........@.@.@...@.....
..@.@..@....@..@..@.....@...@@@@.@..@...@.@@.....@
............@......@.....@.@@@......@....@.@@@.@.@
...@@@@......@..@.@..@.....@...@.@.......@@@......
.@..@.@@...@@...@@.......@.@.....@..@@@.@@..@@@@@@
.....@@@.@.@..@.....@.@.@@.....@@.@@@.@@.@........
.......@.@.....@.@@.@....@.@.@...@@..@.....@....@.
@.@...@.@.@.@.......@.....@.@.....@@@....@@..@...@
...@.@....@@@..@...@....@..@......@...@...@@.@..@.
.......@..@..@@..@.@.@.@........@.@.@...@@..@..@@.
@.@...@..@@....@@@........@....@.......@.....@..@@
...@@...@..@@@.....@........@..@...@@.@@......@..@
...@@...@.@@........@@@...........@..@.@..........
.@....@@..@.@.@.@.@.....@.@......@.....@.......@..
.@@@..@@.@.@...@....@.@@.@......@......@@......@.@
.@....@...@.@.@..@@....@.@@........@.@..@.@.@....@
@.@...@..........@@@.......@.@..@......@.....@...@
@.........@....@@@.@@.....@@@.@@..@.@.............
..@....@..@....@.@.....@@..@@............@@.@@....
@@..@........@....@@...@@....@........@@@..@......
@@.......@......@........@..@@..@@...@...@.....@..
.@@..@.....@@.@..@........@......@@.@..@......@.@.
.@@...@@..@..@..@..@...@.....@@....@..@@@.........
@@.@..............@.@.@@@...@.@@@@.........@...@..
.......@.@.@...@@@@@@.@........@.......@@.@@....@.
.@.@@.....@......@..@.....@..@@@@....@.@@..@..@.@.
...@@@.@...@.@.@....@@@...@@@....@@..@@.@@.@@...@.
...@.@.......@..@.@@......@.@...@...@.@.@..@...@@@
....@....@.@.@@......@..@........@........@@.@@.@@
.@...@.@.@....@@......@..@@....@.@.@@..@....@...@.
@.@..@..@..@.@@..@@@@@.@...@@@@@@..@...@.......@@@
...@.@@@...@@.@.@.@@...@....@....@.@@.@@..@....@.@
..@.@@..@....@...@..@@.@@.....@...@...@........@@.
.@@............@........@@.@...@@.......@@...@...@
.....@@..@....@..........@@.....@.@..@.@..@.@@....

